#############################################################################################################################################################################
#############################################################################################################################################################################
##           ################################################################################################################################################################
##                                      #####################################################################################################################################
##                                                          #################################################################################################################
##                                                                                        ###################################################################################
##                                                                                                           ################################################################
##                                                                                                                               ############################################
##                                                                                                                                          #################################
##                                                                                                                                              #############################
##                                                                                                                                                ###########################
##                                                                                                                                                     ######################
##                                                                                                                                                      #####################
##                                                                                                                                                      #####################
##                                                                                                                                                       ####################
##                                                                                                                                                         ##################
##                                                                                                                                                          #################
##                                                                                                                                                             ##############
##                                                                                                                                                             ##############
##                                                                                                                                                               ############
##                                                                                                                                                                  #########
##                                                                                                                                                                     ######
##                                                                                                                                 ######                               #####
##                                                                                                                               #########                                ###
##                                                                                                                               ##########                                ##
##                                                                                                                               ##########                                 #
##                                                                                                                               ###########                                 
##                                                                                                                              ############                                 
##                                                                                                                              ############                                 
##                                                                                                                             ##############                                
##                                                                                                                            ################                               
##                                                                                                                           ###################                             
##                                                                                                                  ##############################                           
##                                                                                                          #######################################                          
##                                                                                              #####################################################                        
##                                                                                         ###########################################################                       
##                                                                                        ##############################################################                     
##                                                                                        ################################################################                   
##                                                                                        ####################################################################               
##                                                                                      ########################################################################             
##                                                                                     #############################################################################         
##                                                                                     #################################################################################     
##                                                                            ###############################################################################################
##                                                                           ################################################################################################
##                                  #########################################################################################################################################
##                          #################################################################################################################################################
##               ############################################################################################################################################################
##       ####################################################################################################################################################################
#############################################################################################################################################################################
#############################################################################################################################################################################
#############################################################################################################################################################################
