#############################################################################################################################################################################
#############################################################################################################################################################################
##                                               ############                  ##                                                                                          ##
##                                               ############                  ##                                                                                          ##
##                                                                             ##                                                                                          ##
##                                                                             ##                                                                                          ##
##                                                                             ##                                                                                          ##
##                                                                             ##                                                                                          ##
##                                                                             ##                                                                                          ##
##                                                                             ##                                                                                          ##
##                                                                             ##############################################################################################
##                                                                             ##############################################################################################
##                                                                             ##############################################################################################
##                                               ############                                                ####################################                            
##                                               ############                                                   ##############################                               
##                                               ############                                                      #######################                                   
##                                               ############                                                                                                
##                                               ############                                                                                                                
##                                               ############                                                                                                                
##                                               ############                                                                                                                
##                                               ############                                                                                                                
##                                               ############                                                                                                                
##                                               ############                                                                                                                
##                                               ############                                                                                                                
##                                               ############                  ##########################                                             #######################
##                                               ############                  #############################                                      ###########################
##                                               ############                  ################################                              ################################
##                                               ############                  ###################################                        ###################################
##                                               ############                  ########################################              ########################################
##                                               ############                                      ##########################################################################
##                                               ############                                                     ########################                                 ##
##                                               ############                                                       ####################                                   ##
##                                               ############                                                          ##############                                      ##
##                                               ############                                                          ##############                                      ##
##                                               ############                                                          ##############                                      ##
##                                               ############                                                          ##############                                      ##
##                                                                                                                         ######                                          ##
##                                                                                                                          ####                                           ##
###############                                                                ########            #####                     ##                                            ##
###############                                                                #######            #####                                                                    ##
##                                                                             ######            #####                                                                     ##
##                                                                             #####            #####                                                                      ##
##                                                                             #####           ######                                                                      ##
##                                                                             #####           ######                                                                      ##
##                                                                             #####           ######                                                                      ##
##                                                                             #####           ######                                                                      ##
##                                                                             #####           ######                                                                      ##
##                                                                             #####           ######                           ##                                         ##
##                                                                             #####           ######                  ################                                    ##
####################################################################################           ##############################################################################
#############################################################################################################################################################################
