#############################################################################################################################################################################
                                     ########################################                        #########################################                               
                                       ################################                                 ##################################                                   
                                        ############################                                            ######################                                       
                                         ###########################                                             ####################                                         
                                         ##########################                                                                                                          
                                         ####################                                                                                                                
                                          ##################                                                                                                                 
                                            ###############                                                                                                                  
                                            ###############                                                                                                                  
                                            #################                                                                                                                
                                             ##############                                                                                                                  
                                             ############                                                                                                                    
                                             ############                                                                                                                    
                                              ################                                                                                                               
                                               ##############                                                                                                                
                                               #############                                                                                                                 
                                                                                                                                                                             
                                                                                                                                                                             
                                                                                                                                                                             
                                                                                                                                                                             
                                                                                                                                                                             
                                                                                                                                                                             
                                                                                                                                                                             
                                                                                                                                                                             
                                                                                                                                                                             
                                                                                                                                                                             
                                                                                                                                                                             
                                                                                                                                                                             
                                                                                                                                                                             
                                                                                                                                                                             
                                         ###############                                                                                                                     
                                         #######################                                                                                                             
                                 #################################                                      ################################                                     
                                 #################################                                      ################################                                     
                                 #################################                                      ################################                                     
                                 #################################                                      ################################                                     
                                 #################################                                      ################################                                     
                                 #################################                                      ################################                                     
                                 #################################                                      ################################                                     
                                 #################################                                      ################################                                     
                                 #################################                                      ################################                                     
                                 #################################                                      ################################                                     
                                 #################################                                      ################################                                     
                                 #################################                                      ################################                                     
                                 #################################                                      ################################                                     
                               #######################################                                ###################################                                    
                            ##############################################                        #########################################                                  
                          #######################################################################################################################                            
#############################################################################################################################################################################
#############################################################################################################################################################################
