#############################################################################################################################################################################
                                     ########################################                        #########################################                               
                                       ################################                                 ##################################                                   
					############################						######################
					###########################						####################
      				 	##########################
					 ####################
					  #################
				           ###############
					    ##############
					    ################
					     #############
					     ############
                                             ############
 					     ################
					      ##############
						############














					   ###############
					######################
                                 #################################                                      ################################
                                 #################################                                      ################################
                                 #################################                                      ################################
                                 #################################                                      ################################
                                 #################################                                      ################################
                                 #################################                                      ################################
                                 #################################                                      ################################
                                 #################################                                      ################################
                                 #################################                                      ################################
                                 #################################                                      ################################
                                 #################################                                      ################################
                                 #################################                                      ################################
                                 #################################                                      ################################
                               #######################################                                ###################################
                            ##############################################                        #########################################
                          #######################################################################################################################
#############################################################################################################################################################################
