##########################################################################################################################           ########################################
##########################################################################################################################           ########################################
##########################          ##                         ##              ###########################################           ########################################
########################                                       ##              ###########################################           ########################################
######################                                         ##              ###########################################           ########################################
###################                                            ##              ###########################################           ########################################
#################                                              ##              ###########################################           ########################################
###############                                             ########           ###########################################           ########################################
##############                                           ##############        ###########################################           ########################################
##############                                         ##################      ###########################################           ########################################
#############                                          ##################      ###########################################           ########################################
############                        ##                ####################     ###########################################           ########################################
#########                        ########             ####################                      ##########################           ########################################
                              ##############           ##################                                                                                                    
                            ##################         ##################                                                                                                    
                            ##################           ##############                                                                                                      
                           ####################             ########                                                                                                         
                           ####################                ##                                                                                                            
                            ##################                                                                                                                               
                            ##################                                                                                                                               
                              ##############                                                                                                                                 
                                 ########                                                                                                                                    
                                    ##                                                                                                                                       
                                                                                                                                                                             
##########                                                                       ####             ####                                                #######################
#############                                                                   #####             ####                       ##                                            ##
##############                                                                  #####             ####                       ##                                            ##
###############                                                                 #####             ####                       ##                                            ##
###############                                                                 #####             ####                       ##                                            ##
###############                                                                 #####             ####                       ##                                            ##
################                                                #               #####             ####                       ##                                            ##
################                                               #                #####             ####                       ##                                            ##
#################                  #                         ##                 #####             ####                       ##                                            ##
#################                 ##                        ##                  #####             ####                       ##                                            ##
##################               ###                      ###                   #####             ####                       ##                                            ##
####################            ####                   #####                    #####             ####                       ##                                            ##
#######################       ######                 #####                      #####             ####                       ##                                            ##
####################################               ######                       #####             ####                       ##                                            ##
####################################             #######                        #####             ####                       ##                                            ##
####################################          #########                         #####            #####                                                                     ##
####################################       ###########                          #####            ####                                                                      ##
####################################    #############                           #####           #####                                                                      ##
####################################################                            #####           #####                                                                      ##
###################################################                             #####           #####                                                                      ##
##################################################                             ####               ###                                                                      ##
#################################################                              #####           ######                                                                      ##
################################################                               #####           ######                                                                      ##
####################################################                           #####           ######                           ##                                         ##
##############################################################                 #####           ######                  ################                                    ##
####################################################################################           ##############################################################################
####################################################################################           ##############################################################################
