##############################################################################                     ##########################################################################
#############################################################################                        ########################################################################
#######################################################################                                 #####################################################################
####################################################################                                            #############################################################
###################################################################                                             #############################################################
###################################################################                                                                                                          
#############################################################                                                                                                                
############################################################                                                                                                                 
###########################################################                                                                                                                  
###########################################################                                                                                                                  
#############################################################                                                                                                                
###########################################################                                                                                                                  
#########################################################                                                                                                                    
#########################################################                                                                                                                    
##############################################################                                                                                                               
#############################################################                                                                                                                
############################################################                                                                                                                 
#######################                                                                                                                                                      
#############                                                                                                                                                                
##########                                                                                                                                                                   
########                                                                                                                                                                     
#####                                                                                                                                                                        
####                                                                                                                                                                         
###                                                                                                                                                                          
##                                                                                                                                                                           
#                                                                                                                                                                           
                                                                                                                                                                             
                                                                                                                                                                             
                                                                                                                                                                             
                                                                                                                                                                             
                                                                                                                                                                             
                                           #############                                                                                                                     
                                         ######################################              ###############                                                                 
                                    #######################################                      #######################################                                     
                                  ######################################                              ##################################                                     
                                 #####################################                                  ################################                                     
                                 ###################################                                    ################################                                     
                                 #################################                                      ################################                                     
                                 #################################                                      ####################################                                 
                                 #################################                                      #####################################                                
                                 #################################                                      ######################################                               
                                 #################################                                      ##########################################                           
##                               #################################                                      ###############################################                      
##                               #################################                                      #########################################################            
##                               #################################                                      #####################################################################
##                               #################################                                      #####################################################################
##                             #######################################                                #######################################################################
##                          ##############################################                        ###########################################################################
##                        ##################################################                  ###############################################################################
#############################################################################                ################################################################################
#############################################################################                ################################################################################
