##########################################################################################################################           ########################################
########################################################################################################################              #######################################
##########################          ##                         ##                                         ######                       ########################         #####
########################                                       ##                                      ############                     ######################            ###
######################                                         ##                                   ##################                   ####################             ###
###################                                            ##                                   ##################                    ##################              ###
#################                                              ##                                  ####################                    ################               ###
###############                                             ########                               ####################                     ##############                 ##
##############                                           ##############                             ##################                       ############                  ##
##############                                         ##################                           ##################                        ##########                   ##
#############                                          ##################                             ##############                           ########                    ##
############                        ##                ####################                               ########                               ######                     ##
#########                        ########             ####################                                  ##                                   ####                       #
                              ##############           ##################                                                                         ##                         
                            ##################         ##################                                                                                                    
                            ##################           ##############                                                                                                      
                           ####################             ########                                                                                                         
                           ####################                ##                                                                                                            
                            ##################                                                                                                                               
                            ##################                                                                                                                               
                              ##############                                                                                                                                 
                                 ########                                                                                                                                    
                                    ##                                                                                                                                       
                                                                                                                                                                             
##########                                                                       ###                ###                       ###############################################
#############                                                                     ###               ###                      #######################           ##############
##############                                                                    ####               ###                     ###############                            #####
###############                                                                    ####              ####                    ############                                 ###
###############                                                                    ###                ####                  ###########                                    ##
###############                                                                   ####               #####                 ##########                                      ##
################                                                #                 ###                ####                   ########                                       ##
################                                               #                 ####                ###                    ########                                       ##
#################                  #                         ##                 ####                ###                     #######                                        ##
#################                 ##                        ##                 ####                 ###                      #####                                        ###
##################               ###                      ###                  ####                ###                       #####                                      #####
####################            ####                   #####                   ###                ####                       ###                                      #######
#######################       ######                 #####                    ###                ####                         #                                     #########
####################################               ######                     ###               ####                                                            #############
####################################             #######                     ###               ####                                                           ###############
####################################          #########                     ####              #####                                                         #################
####################################       ###########                     ####              #####                                                         ##################
####################################    #############                      ####              #####                                                        ###################
####################################################                       ####               ####                                                     ######################
###################################################                         ###               #####                                                ##########################
##################################################                           ###               ####                                              ############################
#################################################                             ###              ######                                           #############################
################################################                               ###              #####                                      ##################################
####################################################                           ###               #####                    ########      #####################################
##############################################################                 ####             ######                 ######################################################
###################################################################################             #############################################################################
####################################################################################           ##############################################################################
