##########################################################################################################################           ########################################
##########################################################################################################################           ########################################
##########################          ##                         ##              ###########################################           ########################################
########################                                       ##              ###########################################           ########################################
######################                                         ##              ###########################################           ########################################
###################                                            ##              ###########################################           ########################################
#################                                              ##              ###########################################           ########################################
###############                                             ########           ###########################################           ########################################
##############                                           ##############        ###########################################           ########################################
##############                                         ##################      ###########################################           ########################################
#############                                          ##################      ###########################################           ########################################
############                        ##                ####################     ###########################################           ########################################
#########                        ########             ####################                      #############################################################################
                              ##############           ##################                                                                                                  ##
                            ##################         ##################                                                                                                  ##
                            ##################           ##############                                                                                                    ##
                           ####################             ########                                                                                                       ##
                           ####################                ##                                                                                                          ##
                            ##################                                                                                                                             ##
                            ##################                                                                                                                             ##
                              ##############                                                                                                                               ##
                                 ########                                                                                                                                  ##
                                    ##                                                                                                                                     ##
                                                                                                                                                                           ##
##########                                                                       ####             ####                                                #######################
#############                                                                   #####             ####                       ##                                            ##
##############                                                                  #####             ####                       ##                                            ##
###############                                                                 #####             ####                       ##                                            ##
###############                                                                 #####             ####                       ##                                            ##
###############                                                                 #####             ####                       ##                                            ##
################                                                #               #####             ####                       ##                                            ##
################                                               #                #####             ####                       ##                                            ##
#################                  #                         ##                 #####             ####                       ##                                            ##
#################                 ##                        ##                  #####             ####                       ##                                            ##
##################               ###                      ###                   #####             ####                       ##                                            ##
####################            ####                   #####                    #####             ####                       ##                                            ##
#######################       ######                 #####                      #####             ####                       ##                                            ##
####################################               ######                       #####             ####                       ##                                            ##
####################################             #######                        #####             ####                       ##                                            ##
####################################          #########                         #####            #####                                                                     ##
####################################       ###########                          #####            ####                                                                      ##
####################################    #############                           #####            ####                                                                      ##
####################################################                            #####            ####                                                                      ##
###################################################                             #####            ####                                                                      ##
##################################################                             ######            ####                                                                      ##
#################################################                              ######            ####                                                                      ##
################################################                               ######            ####                                                                      ##
####################################################                           ######            ####                           ##                                         ##
##############################################################                 ######            ####                  ################                                    ##
#############################################################################################################################################################################
#############################################################################################################################################################################
