##########################################################################################################################           ########################################
##########################################################################################################################           ########################################
##########################          ##                         ##              ###########################################           ########################################
########################                                       ##              ###########################################           ########################################
######################                                         ##              ###########################################           ########################################
###################                                            ##              ###########################################           ########################################
#################                                              ##              ###########################################           ########################################
###############                                             ########           ###########################################           ########################################
##############                                           ##############        ###########################################           ########################################
##############                                         ##################      ###########################################           ########################################
#############                                          ##################      ###########################################           ########################################
############                        ##                ####################     ###########################################           ########################################
#########                        ########             ####################                      #############################################################################
                                                                                                                                                                           ##
                                                                                                                                                                           ##
                                                                                                                                                                           ##
                                                                                                                                                                           ##
                                                                                                                                                                           ##
                                                                                                                                                                           ##
                                                                                                                                                                           ##
                                                                                                                                                                           ##
                                                                                                                                                                           ##
                                                                                                                                                                           ##
                                                                                                                                                                           ##
#####                                                                                                                                                                      ##
##                                                                                                                                                                         ##
##                                                                                                                                                                         ##
##                                                                                                                                                                         ##
##                                                                                                                                                                         ##
##                                                                                                                                                                         ##
##                                                                                                                                                                         ##
##                                                                                                                                                                         ##
##                                                                                                                                                                         ##
##                                                                                                                                                                         ##
##                                                                                                                                                                         ##
##                                                                                                                                                                         ##
##                                                                                                                                                                         ##
##                                                                                                                                                                         ##
##                                                                                                                                                                         ##
##                                                                                                                                                                         ##
##                                                                                                                                                                         ##
##                                                                                                                                                                         ##
##                                                                                                                                                                         ##
##                                                                                                                                                                         ##
##                                                                                                                                                                         ##
##                                                                                                                                                                         ##
##                                                                                                                                                                         ##
##                                                                                                                                                                         ##
##                                                                                                                                                                         ##
#############################################################################################################################################################################
#############################################################################################################################################################################
