#############################################################################################################################################################################
#############################################################################################################################################################################
#########                 ##############            ##############             ##############                 ###############################################################
#########                 ##############            ##############             ##############                                                                              ##
#########                 ##############            ##############             ##############                                                                              ##
#########                 ##############            ##############             ##############                                                                              ##
#########                 ##############            ##############             ##############                                                                              ##
#########                 ##############            ##############             ##############                                                                              ##
#########                                           ##############             ##############                                                                              ##
#########                                           ##############             ##############                                                                              ##
#########                                           ##############             ##############                                                                              ##
#########                                           ##############             ##############                                                                              ##
#########                                                                      #            #                 ##################################################           ##
                                                                               #            #                 #                                                #           ##
                                                                               #            #                 #                                                #           ##
                                                                               #            #                 #                                                #           ##
                                                                               #            #                 ##################################################           ##
                                                                               ##############                 ##################################################           ##
                                                                                                                                                                           ##
                                                                                                                                                                           ##
                          ##############                                                                                                                                   ##
                          #            #                                                                                                                                   ##
                          #            #                                                                                                                                   ##
                          #            #            ##############                                                                                                         ##
#########                 #            #            #            #                                                                                                         ##
#########                 #            #            #            #                                                                                                         ##
#########                 #            #            #            #                                                                                                         ##
#########                 #            #            #            #                                                                                                         ##
#########                 #            #            #            #                                                                                                         ##
#########                 #            #            #            #             ##############                                                                              ##
#########                 #            #            #            #             #            #                                                                              ##
#########                 #            #            #            #             #            #                                                                              ##
#########                 #            #            #            #             #            #                                                                              ##
#########                 #            #            #            #             #            #                                                                              ##
#########                 #            #            #            #             #            #                                                                              ##
#########                 #            #            #            #             #            #                                                                              ##
#########                 #            #            #            #             #            #                 ###############################################################
#########                 #            #            #            #             #            #                 #                                                            ##
#########                 #            #            #            #             #            #                 #                                                            ##
#########                 #            #            #            #             #            #                 #                                                            ##
#########                 #            #            #            #             #            #                 #                                                            ##
#########                 #            #            #            #             #            #                 #                                                            ##
#########                 #            #            #            #             #            #                 #                                                            ##
#########                 #            #            #            #             #            #                 #                                                            ##
#########                 #            #            #            #             #            #                 #                                                            ##
#########                 #            #            #            #             #            #                 #                                                            ##
#########                 #            #            #            #             #            #                 #                                                            ##
#########                 #            #            #            #             #            #                 #                                                            ##
#########                 #            #            #            #             #            #                 #                                                            ##
#############################################################################################################################################################################
#############################################################################################################################################################################
