##########################################################################################################################           ########################################
##########################################################################################################################           ########################################
##########################                                                     ###########################################           ########################################
########################                                                       ###########################################           ########################################
######################                         ########                        ###########################################           ########################################
###################                       ######    #########                  ###########################################           ########################################
#################                   ######                ############         ###########################################           ########################################
###############                  ###                                 #####################################################           ########################################
##############                 ##                                                  #######################################           ########################################
##############               ##                                                           ################################           ############                    ########
#############             ###                                                                    #########################           ##########                         #####
############            ##                                                                            #######################################                             ###
#########             ##                                                                                       #######################                                     ##
##                   ##                                                                                                 ###########                                        ##
##                  ##                                                                                                                                                     ##
##                  ##                                                                                                                                                     ##
##                ##                        #####                                                                                                                          ##
##               #                       ###     ###                                                                                                                       ##
##              ##                    ###          #########                                                                                                               ##
##            ##                     #####                 #######                                                                                                         ##
##           ##                     ##                           #########                                                                                                 ##
##########   #                     ######                               ############                                                                                       ##
##########  #                     ###                                              ###                                                                                     ##
##########  #                    ###                                               ################                                                                        ##
#############                    ##                                             ####          ########                                                                     ##
#############                     ##                                            #####             ##################                                                       ##
##############                     ###                                          #####             ####          ###########                                                ##
###############                      ##                                         #####             ####                    #########                                        ##
###############                       ##                                        #####             ####                             ###                                     ##
###############                       ###                                       #####             ####                                ####                                 ##
################                       ####                                     #####             ###################################    ##                               ###
################                           ###                                  #####                 ###########                  ####   ######                       ######
################                              ###                               #####            ########                             ##       ####                ##########
################                                 ####                           #####       ######                                     ##         ###           #############
################                                     ###########                ############                                            ##          #########################
################                                          ##########      ##########                                                     ##                                ##
#################                                                  ########                                                               ##                               ##
##################                                                                                                                         ##                              ##
######################                                                                                                                      ##                             ##
##########################                                                                                                                   ##                            ##
############################                                                                                                                 ##                            ##
###############################                                                                                                             ##                             ##
#################################                                                                                                          ##                              ##
#################################                                                                                                        ###                               ##
##################################                                                                #####                                ###                                 ##
#####################################                                                          #################                      ###                                  ##
################################################                                         #########################                    ##                                   ##
####################################################                           ####################################                   ##                                   ##
##############################################################        ##############################################                 ###                                   ##
########################################################################################################################             ########################################
##########################################################################################################################           ########################################
