##########################################################################################################################           ########################################
##########################################################################################################################           ########################################
##########################          ##                         ##              ###########################################           ########################################
########################                                       ##              ###########################################           ########################################
######################                                         ##              ###########################################           ########################################
###################                                            ##              ###########################################           ########################################
#################                                              ##              ###########################################           ########################################
###############                                             ########           ###########################################           ########################################
##############                                           ##############        ###########################################           ########################################
##############                                         ##################      ###########################################           ########################################
#############                                          ##################      ###########################################           ########################################
############                        ##                ####################     ###########################################           ########################################
#########                        ########             ####################                      #############################################################################
##                            ##############           ##################                                                                                                  ##
##                          ##################         ##################                                                                                                  ##
##                          ##################           ##############                                                                                                    ##
##                         ####################             ########                                                                                                       ##
##                         ####################                ##                                                                                                          ##
##                          ##################                                                                                                                             ##
##                          ##################                                                                                                                             ##
##                            ##############                                                                                                                               ##
##                               ########                                                                                                                                  ##
##                                  ##                                                                                                                                     ##
##                                                                                                                                                                         ##
##########                                                                       ####             ####                                                #######################
#############                                                                   #####             ####                                                                     ##
##############                                                                  #####             ####                                                                     ##
###############                                                                 #####             ####                                                                     ##
###############                                                                 #####             ####                                                                     ##
###############                                                                 #####             ####                                                                     ##
################                                                #               #####             ####                                                                     ##
################                                               #                #####             ####                                                                     ##
#################                  #                         ##                 #####             ####                                                                     ##
#################                 ##                        ##                  #####             ####                                                                     ##
##################               ###                      ###                   #####             ####                                                                     ##
####################            ####                   #####                    #####             ####                                                                     ##
#######################       ######                 #####                      #####             ####                                                                     ##
####################################               ######                       #####             ####                                                                     ##
####################################             #######                        #####             ####                                                                     ##
####################################          #########                         #####            #####                                                                     ##
####################################       ###########                          #####            ####                                                                      ##
####################################    #############                           #####           #####                                                                      ##
####################################################                            #####           #####                                                                      ##
###################################################                             #####           #####                                                                      ##
##################################################                             ####               ###                                                                      ##
#################################################                              #####           ######                                                                      ##
################################################                               #####           ######                                                                      ##
####################################################                           #####           ######                                                                      ##
##############################################################                 #####           ######                  ###           ##                                    ##
####################################################################################           ###########################           ########################################
##########################################################################################################################           ########################################
