#############################################################################                ################################################################################
####################################################################                                  #######################################################################
###################################                                                                                ##########################################################
#####################                                                                                                     ###################################################
##########                                                                                                                             ######################################
##                                                                                                                                                          #################
##                                                                                                                                                                         ##
##                                                                                                                                                                         ##
##                                                                                                                                                                         ##
##                                                                                                                                                                         ##
##                                                                                                                                                                         ##
##                                                                                                                                                                         ##
##                                                                                                                                                                         ##
##                                                                                                                                                                         ##
##                                                                                                                                                                         ##
##                                                                                                                                                                         ##
##                                                                                                                                                                         ##
##                                                                                                                                                                         ##
##                                                                                                                                                                         ##
##                                                                                                                                                                         ##
##                                                                                                                                                                         ##
##                                                                                                                                                                         ##
##                                                                                                                                                                         ##
##                                                                                                                                                                         ##
##                                                                                                                                                                         ##
##                                                                                                                                                                         ##
##                                                                                                                                                                         ##
##                                                                                                                                                                         ##
##                                                                                                                                                                         ##
##                                                                                                                                                                         ##
##                                                                                                                                                                         ##
##                                                                                                                                                                         ##
##                                                                                                                                                                         ##
##                                                                                                                                                                         ##
##                                                                                                                                                                         ##
##                                                                                                                                                                         ##
##                                                                                                                                                                         ##
##                                                                                                                                                                         ##
##                                                                                                                                                                         ##
##                                                                                                                                                                         ##
##                                                                                                                                                                         ##
##                                                                                                                                                                         ##
##                                                                                                                                                                         ##
##                                                                                                                                                                         ##
##                                                                                                                                                                         ##
##                                                                                                                                                                         ##
##                                                                                                                                                                         ##
##                                                                                                                                                                         ##
##                                                                                                                                                                         ##
##                                                                                                                                                                         ##
#############################################################################################################################################################################
