####################################################################################           ##############################################################################
####################################################################################           ##############################################################################
##                                                                                                                                                      #                  ##
##                                                                                                                                                      #                  ##
##                                                                                                                                                      #                  ##
##                                                           #                                                                                          #                  ##
##                                                           #                                                                                          #                  ##
##                                                           #                                                                                          #                  ##
##                                                           #                                                                                          #                  ##
##                                                           #                                                                                          #                  ##
##                                                           #                                                                                          #                  ##
##                                                           #                                               #                                          #                  ##
##                                                           #                                               #                                                             ##
############################                                 #                                               #                                                             ##
##                                                           #                                               ###########################                                   ##
##                                                                                  ###########              #                                                             ##
##                                                                                                           #                                                             ##
##                                                                                                           #                                                             ##
##                                                                  #                                        #                                                             ##
##                                                                 #                                         #                                                             ##
##                                                                #                                          #                                                             ##
##                                                               #                                                                                    #                    ##
##                                                              #                                                                                      #                   ##
##                                                             #                                                             #                          #                  ##
##                                                            #                                                              #                           #                 ##
##                                                           #                                                               #                            #                ##
##                                                ###########                                                                #                             #               ##
##                                                                                                                           #                              #              ##
##                                                                                                                           #                               #             ##
##              #                                                                                #                           #                                #            ##
##               #                                                                              #                            #                                             ##
##                #                                                                            #                             #                                             ##
##                 #                                                                          #                              #                                             ##
##                  #                                                   ##                   #                               #                                             ##
##                   #                                                    ##                #                                #                                             ##
##                    #                                                     ##             #                                 #                                             ##
##                     #                                                      ##          #           ####                                                                 ##
##                      #                                                       ##       #        ####                                                                     ##
##                       ###########                                              ##    #     ####                                                                         ##
##                                                                                  ## #  ####                                                                             ##
##                                                                                    ####                                                                                 ##
##                                                                                   #                                                                                     ##
##                                                                                  #                                                                                      ##
##                                                                                 #                                                                                       ##
##                                                                                #                                                                                        ##
##                                                                               #                                                                                         ##
##                                                                                                                                                                         ##
##                                                                                                                                                                         ##
##                                                                                                                                                                         ##
#############################################################################################################################################################################
#############################################################################################################################################################################
