#############################################################################################################################################################################
#############################################################################################################################################################################
#############################################################################################################################################################################
#############################################################################################################################################################################
#############################################################################################################################################################################
#############################################################################################################################################################################
#############################################################################################################################################################################
###############################################################             #################################################################################################
######################################################                                #######################################################################################
#########################################                                                  ##################################################################################
##                                                                                                                                                                         ##
##                                                                                                                                                                         ##
##                                                                                                                                                                         ##
##                                                                                                                                                                         ##
##                                                                                                                                                                         ##
##                                                                                                                                                                         ##
##                                                                                                                                                                         ##
##                                                                                                                                                                         ##
##                                                                                                                                                                         ##
##                                                                                                                                                                         ##
##                                                                                                                                                                         ##
##                                                                                                                                                                         ##
##                                                                                                                                                                         ##
##                                                                                                                                                                         ##
##                                                                                                                                                                         ##
##                                                                                                                                                                         ##
##                                                                                                                                                                         ##
##                                                                                                                                                                         ##
##                                                                                                                                                                         ##
##                                                                                                                                                                         ##
##                                                                                                                                                                         ##
##                                                                                                                                                                         ##
##                                                                                                                                                                         ##
##                                                                                                                                                                         ##
##                                                                                                                                                                         ##
##                                                                                                                                                                         ##
##                                                                                                                                                                         ##
##                                                                                                                                                                         ##
##                                                                                                                                                                         ##
##                                                                                                                                                                         ##
##                                                                                                                                                                         ##
##                                                                                                                                                                         ##
##                                                                                                                                                                         ##
##                                                                                                                                                                         ##
##                                                                                                                                                                         ##
##                                                                                                                                                                         ##
#####                                                                                                                                                               #########
#############                                                                                                                                     ###########################
###############################                                                                                                     #########################################
############################################################                                                   ##############################################################
##############################################################################                     ##########################################################################
