####################################################################################           ###########################           ########################################
####################################################################################           ###########################           ########################################
##########################          ##                         ##              #####           ###########################           ########################################
########################                                       ##              #####           ###########################           ########################################
######################                                         ##              #####           ###########################           ########################################
###################                                            ##              #####           ###########################           ########################################
#################                                              ##              #####           ###########################           ########################################
###############                                             ########           #####           ###########################           ########################################
##############                                           ##############        #####           ###########################           ########################################
##############                                         ##################      #####           ###########################           ########################################
#############                                          ##################      #####           ###########################           ########################################
############                        ##                ####################     #####           ###########################           ########################################
#########                        ########             ####################                      #############################################################################
##                            ##############           ##################                                                                                                  ##
##                          ##################         ##################                                                                                                  ##
##                          ##################           ##############                                                                                                    ##
##                         ####################             ########                                                                                                       ##
##                         ####################                ##                                                                                                          ##
##                          ##################                                                                                                                             ##
##                          ##################                                                                                                                             ##
##                            ##############                                                                                                                               ##
##                               ########                                                                                                                                  ##
##                                  ##                                                                                                                                     ##
##########                                                                       ####             ####                                                #######################
#############                                                                   #####             ####                       ##                                            ##
##############                                                                  #####             ####                       ##                                            ##
###############                                                                 #####             ####                       ##                                            ##
###############                                                                 #####             ####                       ##                                            ##
###############                                                                 #####             ####                       ##                                            ##
################                                                #               #####             ####                       ##                                            ##
################                                               #                #####             ####                       ##                                            ##
#################                  #                         ##                 #####             ####                       ##                                            ##
#################                 ##                        ##                  #####             ####                       ##                                            ##
##################               ###                      ###                   #####             ####                       ##                                            ##
####################            ####                   #####                    #####             ####                       ##                                            ##
#######################       ######                 #####                      #####             ####                       ##                                            ##
####################################               ######                       #####             ####                       ##                                            ##
####################################             #######                        #####             ####                       ##                                            ##
####################################          #########                         #####            #####                                                                     ##
####################################       ###########                          #####            ####                                                                      ##
####################################    #############                           #####           #####                                                                      ##
####################################################                            #####           #####                                                                      ##
###################################################                             #####           #####                                                                      ##
##################################################                             ####               ###                                                                      ##
#################################################                              #####           ######                                                                      ##
################################################                               #####           ######                                                                      ##
####################################################                           #####           ######                           ##                                         ##
##############################################################                 #####           ######                  ################                                    ##
####################################################################################           ##############################################################################
#############################################################################################################################################################################
